1111111111111
1CC0001111CP1
1011100000CE1
1CC0010000001
1111111111111