1111111111111
1001000000C11
1111011101111
1P101100000C1
1111111111111