1111111111111
1P0000E000001
1101101111011
10000000000C1
1111111111111