1111111111111111111111
1P00000000000000000001
1000000000000C00000C01
1001110000000000011111
1000001111000000000001
100000C000100000000001
1000000000111100000C01
100000C001111111111001
10001000010E0000111001
1001C00001000000001001
1000100001110000001001
1000000000000000001C01
10000CCCC0000000000001
1111111111111111111111