11111111111111111111111111111
1P000011000000000000000000001
10000000000011000000C00000C01
10011100110000000000000011111
10000011110001100000000000001
100000C0001000000001100000001
10000000001111000110000000C01
100000C0011111111110110000001
10000000011E10001110110000001
1000C00001000000001C000001001
1000111000000000001C000001001
1000000000001C00000000001C111
10000CCCC0000000000001C001001
11111111111111111111111111111