11111111111111111111111111111111111111111111
1000CCC11CC000111111111111C00000000000CCC001
100000000000000000000000C000000000000C111111
10000000CC0111111111111100000111111100000001
10C00000110000CCC111111100000111111100000001
100000000C011111E000000C00000111100C01011001
10C00I000C0111111111111100000111111100C00001
10C00000000CC1001111111001100111C111000100C1
10C0000C0001111CCC1C00C0001C0111C00001C00001
10000C000P0CCC00111111110C000111111100000001
11111111111111111111111111111111111111111111