11111
1C0I1
1P101
10I11
1E111
11111