111111111111111111111111111111
1000CCC11CC000111111111111C001
100000000000000000000000C00001
10000000CC01111111111111000001
10C00000110000CCC1111111000001
100000000C011111E000000C000001
10C00I000C01111111111111000001
10C00000000CC10011111110011001
10C0000C0001111CCC1C00C0001C01
10000C000P0CCC00111111110C0001
111111111111111111111111111111