111111111111111111
10P00000C00I000111
111111100011111111
1000000CC001110001
100111C111000000C1
1011C1111110000C11
1IC00000000011E0C1
111111111111111111
