111111
1PCEI1
100001
111001
1C1001
101I01
10C101
10C001
111111